2 13 31
###############################
#p     b* *    *   *  * * *   #
# # # # # # #*#*# # # #*#*#*# #
#   *  *f * *  *      *   * * #
# #b# #x# #*# # #*#*# # # # #*#
#f   s       **  *  *         #
# # # # # # # # # #*# #*# # # #
#*  *   s  *  *      *        #
# # # # #*# # # #*#*# # # # # #
#*    **  *       *         6 #
# #*# # # # # # #*# # # # # # #
#6          *   *  *          #
###############################